11111111111111111110000011111111
10000000000000011000000000000001
10222220000010010020000020001001
10200020400010010020050020001001
10200020000010000020000020001001
10200020000010010020000020001001
10200020111110010020000021111001
10200020000010010020000020001001
10210120000001001011101110001001
10000000000010010000000000001001
10000000000010010000000000001001
10011133333330011111131111111111
10000000000000000000000000000001
10011133333311110000000000000001
10000000000000010000000000000001
11130000022222210000011223300001
11120000031111113000030000200001
10000000000000010000030000200001
10111110000010000000000000000002
10100010000010010000000000000002
10100010000010010000000000000002
10100010000010010000000000000002
10100010111110010000000000000002
10100010000010010010001000002002
10110110000010022221013000002002
10000000000010000000000000002002
10000000000010000000000000002002
10011111111111110001111111111301
10000000000000000000000000000001
10011111111111110001111111111111
10000000000000000000000000000001
11111111111111111111111111111111